// width height
50 30
// currentMapId
1
// nextMapId gateX gateY
2
//playerId spawnX spawnY
X 1 15
//enemy number
10
//weapon number
5
//enemy info
//enemyId spawnX spawnY
0 3 7
1 46 23
0 13 17
0 28 12
0 18 25
0 31 21
0 46 14
0 42 25
0 46 24
1 26 28
//weapon info
//weaponId spawnX spawnY
0 0 15
1 6 20
2 5 11
3 19 15
4 8 27
// map
6 6 6 6 6 6 6 6 6 6 6 6 6 6 6 6 6 6 6 6 6 6 6 6 6 6 6 6 6 6 6 6 6 6 6 6 3 3 6 6 6 6 6 6 6 6 6 6 6 6
3 3 3 3 6 6 6 6 6 6 6 6 3 3 3 3 3 3 3 0 0 0 0 0 0 0 0 0 0 0 0 0 0 0 0 6 6 6 6 0 0 0 0 0 0 6 6 3 3 3
3 3 5 6 6 0 0 0 0 0 0 6 6 3 5 3 3 0 0 0 0 0 0 0 0 0 0 0 0 0 0 0 0 0 0 0 6 6 0 0 0 0 0 0 0 0 6 3 3 3
3 3 6 6 0 0 0 0 0 0 0 0 6 6 3 3 0 0 0 0 0 0 0 0 0 0 0 0 0 0 0 0 0 0 0 0 0 0 0 0 0 0 0 0 0 0 6 3 5 3
3 6 6 0 0 0 0 0 0 0 0 0 0 6 6 3 0 0 0 0 9 9 9 9 9 9 0 0 0 9 9 9 9 9 9 0 0 0 0 0 0 9 9 0 0 0 6 3 3 3
3 6 0 0 0 0 6 6 6 6 0 0 0 0 6 6 0 0 0 0 9 9 9 9 9 9 0 0 9 9 9 9 9 9 9 9 0 0 0 0 9 9 9 0 0 0 6 3 5 3
3 6 0 0 0 6 9 9 9 9 6 0 0 0 0 6 6 0 0 0 0 0 9 9 0 0 0 0 0 0 0 9 9 0 0 0 0 0 0 9 9 9 9 0 0 0 6 3 3 3
3 6 10 0 0 6 9 9 9 9 9 6 0 0 0 0 6 3 0 0 0 0 9 9 0 0 0 0 0 0 0 9 9 0 0 0 0 0 0 0 0 9 9 0 0 0 6 3 5 3
3 6 6 0 0 0 6 9 1 9 9 9 6 0 0 0 0 1 3 3 0 0 9 9 0 0 0 1 0 0 0 9 9 0 0 0 1 0 0 0 0 9 9 0 0 0 6 3 3 3
3 3 6 0 0 0 6 9 9 9 9 9 9 6 0 0 0 3 3 0 0 0 9 9 0 0 0 0 0 0 0 9 9 0 0 0 0 0 0 0 0 9 9 0 0 0 6 3 5 3
3 3 6 0 0 0 0 6 9 9 1 9 9 9 6 0 0 3 0 0 0 0 9 9 0 0 0 0 0 0 0 9 9 0 0 0 0 0 0 0 0 9 9 0 0 0 6 6 6 6
3 6 6 0 0 0 0 6 9 9 9 9 1 9 9 6 0 3 0 0 9 9 9 9 9 9 0 0 0 0 0 9 9 0 0 0 0 0 0 0 9 9 9 9 0 0 0 0 0 0
3 6 0 0 0 6 9 9 9 1 9 9 9 9 6 0 0 3 0 0 9 9 9 9 9 9 0 0 0 0 0 9 9 0 0 0 0 0 0 0 9 9 9 9 0 0 0 0 0 0
0 0 0 0 6 9 9 9 9 9 9 9 9 6 0 0 0 0 0 0 0 0 0 0 0 0 0 0 0 0 0 0 0 0 0 0 0 0 0 0 0 0 0 0 0 0 0 0 0 0
7 0 0 0 6 9 9 1 9 9 1 9 6 0 0 0 0 0 0 0 0 0 0 0 0 0 0 0 0 0 0 0 0 0 0 0 0 0 0 0 0 0 0 0 0 0 0 0 0 0
0 0 0 0 6 6 9 9 9 9 9 6 0 0 0 0 0 0 0 0 0 8 8 8 8 8 8 8 8 8 8 8 8 8 8 8 8 8 8 8 8 8 8 8 8 8 8 0 0 0
6 6 0 0 0 6 6 9 9 6 6 0 0 0 0 0 6 6 6 6 6 3 3 3 3 3 6 0 0 0 0 0 0 0 0 0 0 0 0 0 0 0 6 3 5 3 6 0 0 7
3 6 6 0 0 0 6 6 6 6 0 0 0 0 0 6 3 5 3 3 3 6 6 6 6 6 0 0 0 0 0 0 0 0 0 0 0 0 0 0 0 0 6 3 5 3 6 0 0 7
3 3 6 6 0 0 0 0 0 0 0 0 0 0 6 3 3 3 3 6 6 0 0 0 0 0 0 0 8 8 8 8 8 8 8 8 8 8 8 8 8 8 8 8 8 8 8 0 0 0
3 3 3 6 0 0 0 0 0 0 0 0 0 0 0 6 6 6 6 0 0 0 0 0 0 0 0 0 0 0 0 0 0 0 0 0 0 0 0 0 0 0 0 0 0 6 6 0 0 0
3 3 5 6 0 0 0 0 0 0 0 0 0 0 0 0 0 0 0 0 0 0 0 0 0 0 0 0 0 0 0 0 0 0 0 0 0 0 0 0 0 0 0 0 0 0 6 0 0 6
3 3 3 6 6 0 0 0 0 0 0 6 0 0 0 0 0 0 0 0 0 8 8 8 8 8 0 0 0 0 0 0 0 0 0 0 0 0 0 8 8 8 0 0 0 0 0 0 0 6
3 3 5 3 6 6 6 0 0 0 6 3 6 0 0 0 0 0 0 6 6 3 3 3 5 3 8 8 8 8 8 8 8 8 8 8 8 8 8 8 8 0 0 0 0 0 0 0 0 6
3 3 3 3 3 3 6 6 6 6 6 3 6 0 0 0 6 6 6 3 3 3 3 3 3 3 3 3 3 3 3 0 0 0 0 0 8 8 8 8 0 0 0 0 0 0 0 0 0 6
3 3 5 3 8 8 8 8 8 8 8 8 8 0 0 0 8 8 8 8 8 8 8 8 8 3 3 3 3 0 0 0 0 0 0 0 0 0 0 0 0 0 0 0 0 0 0 0 0 0
3 3 3 3 0 0 0 0 0 0 0 0 0 0 0 0 0 0 0 0 0 0 0 0 0 8 8 8 8 0 0 0 0 6 0 0 0 0 0 0 0 0 0 0 0 0 0 0 0 6
3 3 5 3 0 0 0 0 0 0 0 0 0 0 0 0 0 0 0 0 0 0 0 0 0 0 0 0 0 0 0 0 0 6 6 6 6 6 6 6 6 0 0 0 0 0 0 0 6 6
3 3 3 3 0 0 0 0 0 0 0 0 0 0 0 0 0 0 0 0 0 0 0 0 0 0 0 0 0 0 0 0 6 6 3 3 3 3 3 3 6 6 0 0 0 0 0 6 6 3
3 3 5 3 8 8 8 8 8 8 8 8 8 8 8 8 8 8 8 8 8 8 8 8 8 0 0 0 0 6 6 6 6 3 5 3 3 3 5 3 3 6 6 0 0 0 6 6 3 3
3 3 3 3 3 3 3 3 3 3 3 3 3 3 3 3 3 3 3 3 3 3 3 3 3 6 6 6 6 6 3 3 3 3 3 3 3 3 3 3 3 3 6 6 0 6 6 3 3 3
