// width height
20 20
// currentMapId
2
// nextMapId gateX gateY
1
//playerId spawnX spawnY
X 2 11
//enemy number
5
//weapon number
5
//enemy info
//enemyId spawnX spawnY
0 8 16
1 10 9
1 7 3
1 17 15
2 17 7
//weapon info
//weaponId spawnX spawnY
0 1 10
1 11 5
2 11 17
3 18 17
4 18 4
// map
0 0 6 9 9 9 3 3 0 0 0 0 0 0 0 0 0 9 3 3
0 0 6 9 9 9 3 3 0 0 0 0 0 0 0 0 0 9 3 3
0 0 6 9 9 9 0 0 0 0 0 0 0 0 0 0 0 9 9 9
0 1 6 9 9 9 0 0 0 0 0 0 0 3 3 0 0 0 0 9
0 0 6 9 9 9 0 0 0 0 0 0 0 3 3 0 0 0 0 0
0 0 6 9 9 9 0 0 0 0 0 0 0 0 0 0 0 0 0 0
6 6 6 9 9 9 1 1 1 1 1 1 0 0 0 0 0 0 0 0
8 8 8 8 8 8 8 8 8 8 8 8 0 0 0 0 0 0 0 0
0 0 10 0 0 0 0 0 0 0 0 0 0 0 0 0 0 0 0 0
0 0 0 0 0 0 0 0 0 0 0 0 0 0 0 0 0 0 0 0
0 0 0 0 0 0 0 0 0 0 0 0 0 0 0 0 0 0 0 0
0 0 0 0 0 0 0 0 0 0 0 0 0 0 0 0 0 0 0 0
8 8 8 8 8 8 8 8 8 8 8 8 0 0 0 0 0 0 0 0
6 6 6 9 9 9 1 1 1 1 1 1 0 0 0 0 0 0 0 0
0 0 6 9 9 9 0 0 0 0 0 0 0 0 0 0 0 0 0 0
0 0 6 9 9 9 0 0 0 0 0 0 0 3 3 0 0 0 0 0
0 1 6 9 9 9 0 0 0 0 0 0 0 3 3 0 0 0 0 9
0 0 6 9 9 9 0 0 0 0 0 0 0 0 0 0 0 9 9 9
0 0 6 9 9 9 3 3 0 0 0 0 0 0 0 0 0 9 3 3
0 0 6 9 9 9 3 3 0 0 0 0 0 0 0 0 0 9 3 3
